20 20
00000001111100000001
11111100111101111100
11011110011000011110
10010111011011000110
10110110001011110110
10110000101011000011
10111110001011011000
00000000000011111011
01111111001100001001
00111000001111101101
10000011111100001001
11101110000101111011
11111111111001111011
00000000000011000001
01111111111111011101
01111111011111111101
00000000011100000101
01111111000111010001
01111111111111011111
00000000000000000000
8 12
0 0