6 17
00001000001110001
11101011001101101
10001011001100101
11101011001101101
11100011001101101
10001000000001100
0 0
5 16