9 10
0111111111
0110000000
0000111110
1011101010
1000001000
1011011101
1010001111
0000100000
1111111110
5 8
8 9