9 10
0111111111
0110000000
0000111110
1011111010
1000011000
1111011101
1110001111
0000100000
1111111110
8 9
0 0