9 10
0111111111
0110000000
0000111110
1011111010
1000011000
0111011111
0110001100
0000100010
1110111110
0 0
8 9




