5 8
00110000
10110110
10110110
10111110
10000000
2 4
0 0
