14 20
00000000000000000000
11111111111111111110
00000000000000000010
00000000000000000010
01000000000000000010
01000000000000000010
01000000000000000010
01000000000000000010
01000000000000000010
01000000000000000010
01000000000000000010
01111111111111111000
01111111111111111111
00000000000000000000
0 0
13 19
